1 1 1 1 1 1 1 1 1 1 1 1 1 1 1 1
1 2 2 2 2 2 2 2 2 2 2 2 2 2 2 1
1 2 3 3 3 3 3 3 3 4 4 4 3 3 2 1
1 2 5 5 5 5 5 6 6 6 6 6 6 6 2 1
1 2 5 1 1 1 5 6 6 6 6 6 6 6 2 1
1 2 5 1 1 1 5 6 6 6 6 6 6 6 2 1
1 2 5 5 5 5 5 6 6 6 6 6 6 6 2 1
1 2 6 6 6 6 6 6 6 6 6 6 6 6 2 1
1 2 6 6 6 6 6 6 6 6 6 6 6 6 2 1
1 2 6 6 6 6 6 6 6 6 6 6 6 6 2 1
1 2 2 2 2 2 2 2 2 2 2 2 2 2 2 1
1 1 1 1 1 1 1 1 1 1 1 1 1 1 1 1